OOOOOOOOUOOOOOOOO
OBUUUUOUUUOUUUUBO
OUOOOUOUUUOUOOOUO
OUOUUUUOUOUUUUOUO
OUOUOUUUUUUUOUOUO
OUUUUUOUOUOUUUUUO
OUOUUUUOCOUUUUOUO
OUOUOUOOCOOUOUOUO
UUUUOUUUCUUUOUUUU
OUOUOUOOCOOUOUOUO
OUOUUUUUOUUUUUOUO
OUUUUOOUUUOOUUUUO
OUOUUUUOUOUUUUOUO
OUOUUUUUUUUUUUOUO
OUOOOUOOOOOUOOOUO
OBUUUUUUUUUUUUUBO
OOOOOOOOUOOOOOOOO
